[-----------------------]
[------]............[].._
_..................[----]
[--------].....[---]...._
_......................._
_...........[------]...[]
_.._....[----------]..[-]
_....................[--]
[----].................._
[--------]........[]...._
_..................[----]
[---]....[]...[--].....[]
[----]..................T
_.......................|
[-----------------------]
